########################################
#......................................#
#......................................#
#......................................#
#......................................#
#.........#######################......#
#.........#.....................#......#
#.........#.....................#......#
#.........#.....................#......#
#.........#.........#...........#......#
#.........#.........####........#......#
..........#.........#...........#.......
..........#.........#...........#.......
..........#.....................#.......
..........#.....................#.......
..........#.....................#.......
........................................
........................................
........................................
........................................
........................................
........................................
........................................
........................................
...........#............................
...........#............................
...........#............................
...........#..............#.............
...........#..............#.............
...........#..............#.............
...........#########......#.............
...................#......#.............
...................#......#.............
...................#......#.............
...................########.............
........................................
........................................
........................................
........................................
........................................